000000000000000000-
111001111001110000-
001001001001010000-
001001001001010000-
001001001001010000-
001001001001011000-
001001001001000000-
001001001001000000-
001111001111000000-
000000000000000000