00000000000000000-
11110011111100000-
11110011111100000-
00110011001100000-
00110011001100000-
00110011001100000-
00110011001100000-
00111111001111000-
00111111001111000-
00000000000000000
